0 0 0 0 0 0 0 0 0 0 0 0 0 0 0 0
0 0 0 0 0 0 0 0 0 2 2 6 2 2 0 0
0 0 0 0 0 0 0 0 4 1 1 1 1 1 5 0
0 0 0 0 0 0 0 0 4 1 1 1 1 1 5 0
0 0 0 0 0 0 0 0 8 1 1 1 1 1 5 0
0 0 2 2 6 2 2 2 1 1 1 1 1 1 5 0
0 4 1 1 1 1 1 1 1 1 1 1 1 1 9 0
0 4 1 1 1 1 1 1 1 1 1 1 1 1 5 0
0 8 1 1 1 1 1 1 1 1 1 1 1 1 5 0
0 4 1 1 1 1 1 1 1 1 1 1 1 1 5 0
0 0 3 3 7 3 3 3 3 3 3 7 3 3 0 0
0 0 0 0 0 0 0 0 0 0 0 0 0 0 0 0